wwwwwwwwwwwww
w-----------w
w------p----w
w-----------w
www------wwww
wwww--*-wwwww
w-----------w
w----------&w
wwwwwwwwwwwww
