wwwwwwwwwwwww
w---*------&w
w-----------w
w--------*--w
w---wwwwwwwww
w---wwwwwwwww
w-----------w
w----------pw
wwwwwwwwwwwww
